Day,Market Participant,Tape A Shares,Tape B Shares,Tape C Shares,Total Shares,Tape A Notional,Tape B Notional,Tape C Notional,Total Notional,Tape A Trade Count,Tape B Trade Count,Tape C Trade Count,Total Trade Count
2007-10-26,AMEX (A),1182500,40540710,194100,41917310,0.0,0.0,0.0,0.0,1861,65228,217,67306
2007-10-26,NSX (C),4056827,1826940,11315199,17198966,0.0,0.0,0.0,0.0,21575,3800,46804,72179
2007-10-26,NSX (DC),91665,2000,59117881,59211546,0.0,0.0,0.0,0.0,541,14,152460,153015
2007-10-26,NYSE (DN),137273400,32127600,174359817,343760817,0.0,0.0,0.0,0.0,827329,86178,775712,1689219
2007-10-26,Nasdaq (DQ),657930420,133772081,636283405,1427985906,0.0,0.0,0.0,0.0,820688,68164,589570,1478422
2007-10-26,ADF (D),103638400,21967358,110302500,235908258,0.0,0.0,0.0,0.0,373023,31904,297172,702099
2007-10-26,ISE (I),47735900,4438400,12851700,65026000,0.0,0.0,0.0,0.0,297588,11157,50377,359122
2007-10-26,CHX (M),24805800,4162600,11367233,40335633,0.0,0.0,0.0,0.0,31984,994,14967,47945
2007-10-26,NYSE (N),1399595980,0,0,1399595980,0.0,0.0,0.0,0.0,4491215,0,0,4491215
2007-10-26,NYSE Arca (P),542856000,197789400,416019570,1156664970,0.0,0.0,0.0,0.0,2897253,396703,1549824,4843780
2007-10-26,Nasdaq (Q),682926600,218732948,1213254728,2114914276,0.0,0.0,0.0,0.0,3610207,559719,4229137,8399063
2007-10-26,CBOE (W),2304600,3642000,1016700,6963300,0.0,0.0,0.0,0.0,3584,1521,1296,6401
2007-10-26,PHLX (X),5311700,253300,3061016,8626016,0.0,0.0,0.0,0.0,1114,50,3394,4558
2007-10-29,AMEX (A),1104200,36916339,2300,38022839,0.0,0.0,0.0,0.0,1397,66846,5,68248
2007-10-29,NSX (C),4123349,1732138,14424889,20280376,0.0,0.0,0.0,0.0,22236,3218,65002,90456
2007-10-29,NSX (DC),136710,14200,52365760,52516670,0.0,0.0,0.0,0.0,743,36,142327,143106
2007-10-29,NYSE (DN),125214500,30341500,151543212,307099212,0.0,0.0,0.0,0.0,729431,76302,719373,1525106
2007-10-29,Nasdaq (DQ),638413480,90770226,534211935,1263395641,0.0,0.0,0.0,0.0,878528,68945,608993,1556466
2007-10-29,ADF (D),100786400,22518064,92914400,216218864,0.0,0.0,0.0,0.0,361899,33154,266975,662028
2007-10-29,ISE (I),44367500,3920400,2940500,51228400,0.0,0.0,0.0,0.0,260326,8855,7195,276376
2007-10-29,CHX (M),24074935,2074800,10490316,36640051,0.0,0.0,0.0,0.0,24405,876,13667,38948
2007-10-29,NYSE (N),1216157160,0,0,1216157160,0.0,0.0,0.0,0.0,4028018,0,0,4028018
2007-10-29,NYSE Arca (P),404206900,124049100,300920095,829176095,0.0,0.0,0.0,0.0,2190533,280930,1237802,3709265
2007-10-29,Nasdaq (Q),568907700,173395419,979421260,1721724379,0.0,0.0,0.0,0.0,3049905,459178,3691506,7200589
2007-10-29,CBOE (W),949900,2175100,813100,3938100,0.0,0.0,0.0,0.0,2524,1358,1335,5217
2007-10-29,PHLX (X),3343600,84900,1791549,5220049,0.0,0.0,0.0,0.0,3242,66,5800,9108
2007-10-30,AMEX (A),1771200,35868887,0,37640087,0.0,0.0,0.0,0.0,1924,63368,0,65292
2007-10-30,NSX (C),4310173,3896509,15386106,23592788,0.0,0.0,0.0,0.0,23303,6364,70692,100359
2007-10-30,NSX (DC),165514,8500,59817706,59991720,0.0,0.0,0.0,0.0,572,21,161142,161735
2007-10-30,NYSE (DN),122124000,30623700,157466353,310214053,0.0,0.0,0.0,0.0,717539,77004,758059,1552602
2007-10-30,Nasdaq (DQ),699917700,105290382,551584797,1356792879,0.0,0.0,0.0,0.0,807331,64426,569753,1441510
2007-10-30,ADF (D),94742600,20132802,102472400,217347802,0.0,0.0,0.0,0.0,348299,32055,301843,682197
2007-10-30,ISE (I),43825300,2063600,2264300,48153200,0.0,0.0,0.0,0.0,262494,5226,5992,273712
2007-10-30,CHX (M),23407366,3040200,11030483,37478049,0.0,0.0,0.0,0.0,28325,931,15709,44965
2007-10-30,NYSE (N),1220518750,0,0,1220518750,0.0,0.0,0.0,0.0,4051196,0,0,4051196
2007-10-30,NYSE Arca (P),431136400,139793900,321031356,891961656,0.0,0.0,0.0,0.0,2401637,312015,1326332,4039984
2007-10-30,Nasdaq (Q),589187000,173668378,1024051248,1786906626,0.0,0.0,0.0,0.0,3171179,451824,3767712,7390715
2007-10-30,CBOE (W),1493300,2445400,590200,4528900,0.0,0.0,0.0,0.0,3199,2024,1320,6543
2007-10-30,PHLX (X),4373700,382100,1938726,6694526,0.0,0.0,0.0,0.0,1809,33,4075,5917
2007-10-31,AMEX (A),2621000,49071216,2000,51694216,0.0,0.0,0.0,0.0,2582,74530,1,77113
2007-10-31,NSX (C),4699468,9641213,21637503,35978184,0.0,0.0,0.0,0.0,23494,22318,89603,135415
2007-10-31,NSX (DC),91022,26000,70894716,71011738,0.0,0.0,0.0,0.0,630,45,184309,184984
2007-10-31,NYSE (DN),154310300,50586000,187407148,392303448,0.0,0.0,0.0,0.0,968282,127783,880633,1976698
2007-10-31,Nasdaq (DQ),710417040,140817450,606720869,1457955359,0.0,0.0,0.0,0.0,896161,82897,610160,1589218
2007-10-31,ADF (D),118011700,28150810,117869400,264031910,0.0,0.0,0.0,0.0,429984,43085,364313,837382
2007-10-31,ISE (I),58607600,817400,2151200,61576200,0.0,0.0,0.0,0.0,367863,766,5764,374393
2007-10-31,CHX (M),25480450,3548500,12000299,41029249,0.0,0.0,0.0,0.0,27159,1235,15433,43827
2007-10-31,NYSE (N),1564451790,0,0,1564451790,0.0,0.0,0.0,0.0,4955238,0,0,4955238
2007-10-31,NYSE Arca (P),564654800,239324500,392089689,1196068989,0.0,0.0,0.0,0.0,3241729,488984,1621617,5352330
2007-10-31,Nasdaq (Q),747752900,295689495,1258663687,2302106082,0.0,0.0,0.0,0.0,4150112,734140,4453364,9337616
2007-10-31,CBOE (W),1548500,3246100,802700,5597300,0.0,0.0,0.0,0.0,5407,1199,2058,8664
2007-10-31,PHLX (X),3563100,448100,2080690,6091890,0.0,0.0,0.0,0.0,1223,67,3297,4587
2007-11-01,AMEX (A),2966600,42249349,45700,45261649,0.0,0.0,0.0,0.0,2465,84966,11,87442
2007-11-01,NSX (C),6191877,12338135,18075387,36605399,0.0,0.0,0.0,0.0,35167,24700,86795,146662
2007-11-01,NSX (DC),305294,41044,68982601,69328939,0.0,0.0,0.0,0.0,1392,29,190323,191744
2007-11-01,NYSE (DN),156792200,66597700,196181935,419571835,0.0,0.0,0.0,0.0,984905,156123,942300,2083328
2007-11-01,Nasdaq (DQ),737970640,180793712,598729292,1517493644,0.0,0.0,0.0,0.0,987110,83113,634248,1704471
2007-11-01,ADF (D),137582900,29961200,125165800,292709900,0.0,0.0,0.0,0.0,507574,53283,417553,978410
2007-11-01,ISE (I),52343800,760100,2733800,55837700,0.0,0.0,0.0,0.0,329531,1049,6517,337097
2007-11-01,CHX (M),37519900,6237500,11240026,54997426,0.0,0.0,0.0,0.0,33706,3096,18537,55339
2007-11-01,NYSE (N),1740076370,0,0,1740076370,0.0,0.0,0.0,0.0,5763013,0,0,5763013
2007-11-01,NYSE Arca (P),614037900,295308900,408205794,1317552594,0.0,0.0,0.0,0.0,3465081,587691,1731293,5784065
2007-11-01,Nasdaq (Q),827986360,373405313,1255566522,2456958195,0.0,0.0,0.0,0.0,4527977,919590,4742586,10190153
2007-11-01,CBOE (W),2369500,7678300,754800,10802600,0.0,0.0,0.0,0.0,5975,3298,1727,11000
2007-11-01,PHLX (X),4797900,268000,2190285,7256185,0.0,0.0,0.0,0.0,2118,102,4027,6247
2007-11-02,AMEX (A),4120000,44714880,102100,48936980,0.0,0.0,0.0,0.0,3118,76350,65,79533
2007-11-02,NSX (C),5084851,11175167,18737682,34997700,0.0,0.0,0.0,0.0,27699,24054,87436,139189
2007-11-02,NSX (DC),237890,23600,64468303,64729793,0.0,0.0,0.0,0.0,1215,28,176755,177998
2007-11-02,NYSE (DN),175268300,71876000,191314017,438458317,0.0,0.0,0.0,0.0,1133783,172063,962389,2268235
2007-11-02,Nasdaq (DQ),732095960,186096919,548693338,1466886217,0.0,0.0,0.0,0.0,954334,80635,615009,1649978
2007-11-02,ADF (D),119333700,33256600,105829600,258419900,0.0,0.0,0.0,0.0,469423,51492,349262,870177
2007-11-02,ISE (I),61258900,1099000,2478100,64836000,0.0,0.0,0.0,0.0,382654,1246,7319,391219
2007-11-02,CHX (M),30483650,11670600,10435463,52589713,0.0,0.0,0.0,0.0,32494,1457,16066,50017
2007-11-02,NYSE (N),1714358980,0,0,1714358980,0.0,0.0,0.0,0.0,5920674,0,0,5920674
2007-11-02,NYSE Arca (P),619960200,296461300,386122369,1302543869,0.0,0.0,0.0,0.0,3592277,616706,1619280,5828263
2007-11-02,Nasdaq (Q),864719200,397374802,1192675989,2454769991,0.0,0.0,0.0,0.0,4873987,1024674,4870050,10768711
2007-11-02,CBOE (W),2893600,2189300,879100,5962000,0.0,0.0,0.0,0.0,5289,1324,1560,8173
2007-11-02,PHLX (X),4405500,1261100,1856874,7523474,0.0,0.0,0.0,0.0,1495,157,3878,5530
2007-11-05,AMEX (A),1926700,45121971,0,47048671,0.0,0.0,0.0,0.0,2444,73604,0,76048
2007-11-05,NSX (C),46700480,8253726,15530654,70484860,0.0,0.0,0.0,0.0,300254,17781,74441,392476
2007-11-05,NSX (DC),132111,46700,60205022,60383833,0.0,0.0,0.0,0.0,886,29,172935,173850
2007-11-05,NYSE (DN),173704800,53506900,171087749,398299449,0.0,0.0,0.0,0.0,1057713,132931,858150,2048794
2007-11-05,Nasdaq (DQ),631916640,126353250,476534067,1234803957,0.0,0.0,0.0,0.0,905910,72879,573830,1552619
2007-11-05,ADF (D),114536200,26990500,95301300,236828000,0.0,0.0,0.0,0.0,440244,41418,313033,794695
2007-11-05,ISE (I),6809700,493300,3050700,10353700,0.0,0.0,0.0,0.0,20384,710,8916,30010
2007-11-05,CHX (M),30874185,4811400,10030191,45715776,0.0,0.0,0.0,0.0,29643,964,15541,46148
2007-11-05,NYSE (N),1521822060,0,0,1521822060,0.0,0.0,0.0,0.0,5221200,0,0,5221200
2007-11-05,NYSE Arca (P),568813700,221004700,336468231,1126286631,0.0,0.0,0.0,0.0,3195107,457013,1470051,5122171
2007-11-05,Nasdaq (Q),776859460,293179192,1032382854,2102421506,0.0,0.0,0.0,0.0,4172271,768287,4186995,9127553
2007-11-05,CBOE (W),2179800,2802800,1174700,6157300,0.0,0.0,0.0,0.0,3867,1495,1141,6503
2007-11-05,PHLX (X),3034100,302900,1972110,5309110,0.0,0.0,0.0,0.0,2042,82,4279,6403
2007-11-06,AMEX (A),1585800,36421675,65100,38072575,0.0,0.0,0.0,0.0,1622,69588,25,71235
2007-11-06,NSX (C),5154710,5609751,18278202,29042663,0.0,0.0,0.0,0.0,26029,12912,76129,115070
2007-11-06,NSX (DC),122220,85862,71517659,71725741,0.0,0.0,0.0,0.0,732,81,183477,184290
2007-11-06,NYSE (DN),153555800,44072000,200113117,397740917,0.0,0.0,0.0,0.0,952808,118192,874386,1945386
2007-11-06,Nasdaq (DQ),705511980,122210183,596638506,1424360669,0.0,0.0,0.0,0.0,916399,73752,616667,1606818
2007-11-06,ADF (D),117845200,27429200,123560400,268834800,0.0,0.0,0.0,0.0,437322,40595,363652,841569
2007-11-06,ISE (I),54008200,1097100,3834900,58940200,0.0,0.0,0.0,0.0,325389,1285,8858,335532
2007-11-06,CHX (M),25639600,7378680,16216391,49234671,0.0,0.0,0.0,0.0,31058,910,16571,48539
2007-11-06,NYSE (N),1497090990,0,0,1497090990,0.0,0.0,0.0,0.0,4872401,0,0,4872401
2007-11-06,NYSE Arca (P),563706000,189221800,382952811,1135880611,0.0,0.0,0.0,0.0,3094803,410402,1502757,5007962
2007-11-06,Nasdaq (Q),758275870,237683315,1178185604,2174144789,0.0,0.0,0.0,0.0,4066203,620385,4260475,8947063
2007-11-06,CBOE (W),3372400,3895600,456900,7724900,0.0,0.0,0.0,0.0,3180,1512,1042,5734
2007-11-06,PHLX (X),3534100,218200,2979838,6732138,0.0,0.0,0.0,0.0,2862,79,3967,6908
2007-11-07,AMEX (A),2619000,54785702,5500,57410202,0.0,0.0,0.0,0.0,3351,89328,3,92682
2007-11-07,NSX (C),5473967,8920830,18875637,33270434,0.0,0.0,0.0,0.0,28994,20989,82963,132946
2007-11-07,NSX (DC),243127,55300,71686677,71985104,0.0,0.0,0.0,0.0,1460,25,182418,183903
2007-11-07,NYSE (DN),185444800,60361600,199295573,445101973,0.0,0.0,0.0,0.0,1176984,150231,929060,2256275
2007-11-07,Nasdaq (DQ),724892060,152555162,554457521,1431904743,0.0,0.0,0.0,0.0,915052,91563,601390,1608005
2007-11-07,ADF (D),117011100,33506700,114023500,264541300,0.0,0.0,0.0,0.0,437014,54020,357072,848106
2007-11-07,ISE (I),67896300,1201900,4043800,73142000,0.0,0.0,0.0,0.0,411404,1388,9536,422328
2007-11-07,CHX (M),30737250,6220900,10510930,47469080,0.0,0.0,0.0,0.0,34739,1185,16367,52291
2007-11-07,NYSE (N),1656252710,0,0,1656252710,0.0,0.0,0.0,0.0,5506330,0,0,5506330
2007-11-07,NYSE Arca (P),653096500,279061500,417826313,1349984313,0.0,0.0,0.0,0.0,3665171,615380,1690197,5970748
2007-11-07,Nasdaq (Q),898984359,370926820,1263539274,2533450453,0.0,0.0,0.0,0.0,4955780,949855,4761924,10667559
2007-11-07,CBOE (W),4463500,3717300,1167700,9348500,0.0,0.0,0.0,0.0,5214,2029,1220,8463
2007-11-07,PHLX (X),7133300,707700,1773123,9614123,0.0,0.0,0.0,0.0,1687,78,3969,5734
2007-11-08,AMEX (A),5239900,57041348,202000,62483248,0.0,0.0,0.0,0.0,5787,93396,57,99240
2007-11-08,NSX (C),77318708,16084097,5199940,98602745,0.0,0.0,0.0,0.0,480613,36195,18547,535355
2007-11-08,NSX (DC),212904,77941,78275063,78565908,0.0,0.0,0.0,0.0,1141,78,214219,215438
2007-11-08,NYSE (DN),229402100,74236200,232198742,535837042,0.0,0.0,0.0,0.0,1425268,189809,1076047,2691124
2007-11-08,Nasdaq (DQ),904869640,192807331,730825578,1828502549,0.0,0.0,0.0,0.0,1155905,113951,831568,2101424
2007-11-08,ADF (D),138188300,38695080,167241200,344124580,0.0,0.0,0.0,0.0,521636,63554,496253,1081443
2007-11-08,ISE (I),6661100,1192700,42893700,50747500,0.0,0.0,0.0,0.0,19661,1026,197319,218006
2007-11-08,CHX (M),26083800,4374400,12413206,42871406,0.0,0.0,0.0,0.0,31934,1262,19326,52522
2007-11-08,NYSE (N),2187534220,0,0,2187534220,0.0,0.0,0.0,0.0,7376565,0,0,7376565
2007-11-08,NYSE Arca (P),820029300,336485900,611942856,1768458056,0.0,0.0,0.0,0.0,4559078,747810,2373451,7680339
2007-11-08,Nasdaq (Q),1083858125,459365600,1723020286,3266244011,0.0,0.0,0.0,0.0,5960439,1200810,6225180,13386429
2007-11-08,CBOE (W),2645200,4729500,769500,8144200,0.0,0.0,0.0,0.0,5255,1359,1329,7943
2007-11-08,PHLX (X),6018800,452100,7334969,13805869,0.0,0.0,0.0,0.0,1133,175,2326,3634
2007-11-09,AMEX (A),2396500,45888540,165200,48450240,0.0,0.0,0.0,0.0,2795,83322,57,86174
2007-11-09,NSX (C),6426803,12113732,21792609,40333144,0.0,0.0,0.0,0.0,33242,27687,97626,158555
2007-11-09,NSX (DC),940507,1863017,64194107,66997631,0.0,0.0,0.0,0.0,3715,2099,186590,192404
2007-11-09,NYSE (DN),202506000,62460000,234102025,499068025,0.0,0.0,0.0,0.0,1270929,160647,1077582,2509158
2007-11-09,Nasdaq (DQ),705790640,150097613,634886307,1490774560,0.0,0.0,0.0,0.0,973252,87300,674412,1734964
2007-11-09,ADF (D),114556910,31671540,121879900,268108350,0.0,0.0,0.0,0.0,433881,53512,382311,869704
2007-11-09,ISE (I),81531900,1833100,4937900,88302900,0.0,0.0,0.0,0.0,484460,1525,12406,498391
2007-11-09,CHX (M),22420400,4078300,8551130,35049830,0.0,0.0,0.0,0.0,16961,585,8638,26184
2007-11-09,NYSE (N),1823318350,0,0,1823318350,0.0,0.0,0.0,0.0,6163789,0,0,6163789
2007-11-09,NYSE Arca (P),714758600,272864700,512459513,1500082813,0.0,0.0,0.0,0.0,4048665,624351,1997616,6670632
2007-11-09,Nasdaq (Q),944158287,375043119,1460893321,2780094727,0.0,0.0,0.0,0.0,5239966,978597,5402592,11621155
2007-11-09,CBOE (W),3260700,2615000,1282900,7158600,0.0,0.0,0.0,0.0,4389,1150,1556,7095
2007-11-09,PHLX (X),4274600,1423400,1945549,7643549,0.0,0.0,0.0,0.0,1569,231,4907,6707
2007-11-12,AMEX (A),2455900,45224419,133700,47814019,0.0,0.0,0.0,0.0,2996,87007,78,90081
2007-11-12,NSX (C),11194089,10443920,20591092,42229101,0.0,0.0,0.0,0.0,67189,24930,91399,183518
2007-11-12,NSX (DC),4925596,2935129,74562392,82423117,0.0,0.0,0.0,0.0,20070,3154,195289,218513
2007-11-12,NYSE (DN),187987300,59306300,225831475,473125075,0.0,0.0,0.0,0.0,1215006,160674,1094553,2470233
2007-11-12,Nasdaq (DQ),605695180,153218985,575464693,1334378858,0.0,0.0,0.0,0.0,913798,93872,622997,1630667
2007-11-12,ADF (D),105931400,26929400,126588500,259449300,0.0,0.0,0.0,0.0,410222,47852,359802,817876
2007-11-12,ISE (I),62112400,1615900,4270000,67998300,0.0,0.0,0.0,0.0,386552,1817,10713,399082
2007-11-12,CHX (M),19519000,4175900,8667815,32362715,0.0,0.0,0.0,0.0,25758,1100,11493,38351
2007-11-12,NYSE (N),1704090910,0,0,1704090910,0.0,0.0,0.0,0.0,5896229,0,0,5896229
2007-11-12,NYSE Arca (P),635850600,257064000,492888664,1385803264,0.0,0.0,0.0,0.0,3756880,585491,1946750,6289121
2007-11-12,Nasdaq (Q),847716562,339235097,1376417489,2563369148,0.0,0.0,0.0,0.0,4803557,918130,5217788,10939475
2007-11-12,CBOE (W),1771900,6031800,500300,8304000,0.0,0.0,0.0,0.0,4771,1770,1026,7567
2007-11-12,PHLX (X),4363600,206800,2355340,6925740,0.0,0.0,0.0,0.0,2233,213,4468,6914
2007-11-13,AMEX (A),2824100,50096583,283800,53204483,0.0,0.0,0.0,0.0,2489,81195,90,83774
2007-11-13,NSX (C),5760876,8151729,19208211,33120816,0.0,0.0,0.0,0.0,30112,19321,87919,137352
2007-11-13,NSX (DC),8519344,2908340,82311038,93738722,0.0,0.0,0.0,0.0,33241,3496,204342,241079
2007-11-13,NYSE (DN),183692600,54744400,222021029,460458029,0.0,0.0,0.0,0.0,1119277,137883,1033991,2291151
2007-11-13,Nasdaq (DQ),697794610,135598190,597375554,1430768354,0.0,0.0,0.0,0.0,846565,87627,597710,1531902
2007-11-13,ADF (D),104141000,28000200,125531500,257672700,0.0,0.0,0.0,0.0,384689,48002,337822,770513
2007-11-13,ISE (I),70476200,1543900,4301500,76321600,0.0,0.0,0.0,0.0,421399,1553,12615,435567
2007-11-13,CHX (M),23642200,5768500,10064271,39474971,0.0,0.0,0.0,0.0,25436,1023,10461,36920
2007-11-13,NYSE (N),1654847820,0,0,1654847820,0.0,0.0,0.0,0.0,5100015,0,0,5100015
2007-11-13,NYSE Arca (P),613178100,239452900,438895351,1291526351,0.0,0.0,0.0,0.0,3434942,492355,1722925,5650222
2007-11-13,Nasdaq (Q),779024971,283706547,1312448610,2375180128,0.0,0.0,0.0,0.0,4249895,722613,4661447,9633955
2007-11-13,CBOE (W),2132500,3187600,1613100,6933200,0.0,0.0,0.0,0.0,5178,1207,1400,7785
2007-11-13,PHLX (X),8384700,268700,2558180,11211580,0.0,0.0,0.0,0.0,2892,93,4071,7056
2007-11-14,AMEX (A),2531600,37201587,203300,39936487,0.0,0.0,0.0,0.0,2047,71324,91,73462
2007-11-14,NSX (C),6168180,7169145,17555432,30892757,0.0,0.0,0.0,0.0,33146,16650,84377,134173
2007-11-14,NSX (DC),7653941,3051640,66950049,77655630,0.0,0.0,0.0,0.0,31114,2828,170472,204414
2007-11-14,NYSE (DN),176220400,53311100,191517314,421048814,0.0,0.0,0.0,0.0,1075835,129959,898635,2104429
2007-11-14,Nasdaq (DQ),711486270,128378581,541857378,1381722229,0.0,0.0,0.0,0.0,827215,75906,561670,1464791
2007-11-14,ADF (D),101357410,26769810,115986800,244114020,0.0,0.0,0.0,0.0,378077,45467,325908,749452
2007-11-14,ISE (I),62479800,940040,2663700,66083540,0.0,0.0,0.0,0.0,365444,1222,8055,374721
2007-11-14,CHX (M),24225340,3780000,10612898,38618238,0.0,0.0,0.0,0.0,24374,1148,9952,35474
2007-11-14,NYSE (N),1587372080,0,0,1587372080,0.0,0.0,0.0,0.0,5023033,0,0,5023033
2007-11-14,NYSE Arca (P),595494400,214685200,413852267,1224031867,0.0,0.0,0.0,0.0,3241977,456800,1599213,5297990
2007-11-14,Nasdaq (Q),753263152,281121176,1197963062,2232347390,0.0,0.0,0.0,0.0,4093630,707158,4387250,9188038
2007-11-14,CBOE (W),3967900,3222300,1242500,8432700,0.0,0.0,0.0,0.0,4878,1648,1244,7770
2007-11-14,PHLX (X),3833600,339400,1759081,5932081,0.0,0.0,0.0,0.0,1915,160,4107,6182
2007-11-15,AMEX (A),4406300,47472037,210800,52089137,0.0,0.0,0.0,0.0,3358,75874,114,79346
2007-11-15,NSX (C),4941792,9330532,18024539,32296863,0.0,0.0,0.0,0.0,27226,22568,87856,137650
2007-11-15,NSX (DC),9116959,3695832,60574886,73387677,0.0,0.0,0.0,0.0,37958,3748,175047,216753
2007-11-15,NYSE (DN),183407000,63076700,185286209,431769909,0.0,0.0,0.0,0.0,1135499,160414,909764,2205677
2007-11-15,Nasdaq (DQ),720967800,148002381,502225248,1371195429,0.0,0.0,0.0,0.0,795921,73022,523309,1392252
2007-11-15,ADF (D),107197800,31904540,102449400,241551740,0.0,0.0,0.0,0.0,412638,51735,330797,795170
2007-11-15,ISE (I),67965900,1332100,2752600,72050600,0.0,0.0,0.0,0.0,406065,1638,7610,415313
2007-11-15,CHX (M),25776402,9205400,11240280,46222082,0.0,0.0,0.0,0.0,24342,1826,9940,36108
2007-11-15,NYSE (N),1471352980,0,0,1471352980,0.0,0.0,0.0,0.0,4773899,0,0,4773899
2007-11-15,NYSE Arca (P),580905600,246224200,375256872,1202386672,0.0,0.0,0.0,0.0,3337303,551528,1576097,5464928
2007-11-15,Nasdaq (Q),793988343,333916455,1134061277,2261966075,0.0,0.0,0.0,0.0,4439939,837356,4425438,9702733
2007-11-15,CBOE (W),5934300,1900500,1076900,8911700,0.0,0.0,0.0,0.0,6059,986,1317,8362
2007-11-15,PHLX (X),3202800,201300,2288388,5692488,0.0,0.0,0.0,0.0,2003,154,4369,6526
2007-11-16,AMEX (A),3614500,45260727,144600,49019827,0.0,0.0,0.0,0.0,2468,68247,64,70779
2007-11-16,NSX (C),5595382,8637636,18752595,32985613,0.0,0.0,0.0,0.0,31054,20950,91074,143078
2007-11-16,NSX (DC),6794941,3459626,65274540,75529107,0.0,0.0,0.0,0.0,27734,3630,188393,219757
2007-11-16,NYSE (DN),168810800,69201000,188066585,426078385,0.0,0.0,0.0,0.0,1063136,176957,938320,2178413
2007-11-16,Nasdaq (DQ),717651640,177436127,540272226,1435359993,0.0,0.0,0.0,0.0,800626,67615,548269,1416510
2007-11-16,ADF (D),99985900,27427500,107719200,235132600,0.0,0.0,0.0,0.0,386964,48961,351987,787912
2007-11-16,ISE (I),58205600,971700,2671600,61848900,0.0,0.0,0.0,0.0,349092,1277,7288,357657
2007-11-16,CHX (M),24148998,5867200,12182159,42198357,0.0,0.0,0.0,0.0,22471,1119,12230,35820
2007-11-16,NYSE (N),1773271000,0,0,1773271000,0.0,0.0,0.0,0.0,5364676,0,0,5364676
2007-11-16,NYSE Arca (P),549999700,248357900,392299177,1190656777,0.0,0.0,0.0,0.0,3104602,558578,1656427,5319607
2007-11-16,Nasdaq (Q),752533098,311132917,1332982140,2396648155,0.0,0.0,0.0,0.0,4095724,813971,4487444,9397139
2007-11-16,CBOE (W),3099300,7187000,1239300,11525600,0.0,0.0,0.0,0.0,5567,1895,1333,8795
2007-11-16,PHLX (X),6434400,112800,1876909,8424109,0.0,0.0,0.0,0.0,1929,75,4026,6030
2007-11-19,AMEX (A),3361300,43697328,10500,47069128,0.0,0.0,0.0,0.0,2508,76374,7,78889
2007-11-19,NSX (C),4472321,9223536,16712185,30408042,0.0,0.0,0.0,0.0,23425,19556,84456,127437
2007-11-19,NSX (DC),7137305,4061517,53532913,64731735,0.0,0.0,0.0,0.0,30876,4016,165802,200694
2007-11-19,NYSE (DN),163896400,64856100,169808748,398561248,0.0,0.0,0.0,0.0,990204,155514,845777,1991495
2007-11-19,Nasdaq (DQ),728763640,177472102,459104764,1365340506,0.0,0.0,0.0,0.0,897027,75854,536697,1509578
2007-11-19,ADF (D),111642500,28887200,101911100,242440800,0.0,0.0,0.0,0.0,423556,48814,337936,810306
2007-11-19,ISE (I),68463800,1189500,2914200,72567500,0.0,0.0,0.0,0.0,390729,1122,8666,400517
2007-11-19,CHX (M),21356650,5097200,9273690,35727540,0.0,0.0,0.0,0.0,23894,1086,9688,34668
2007-11-19,NYSE (N),1676946730,0,0,1676946730,0.0,0.0,0.0,0.0,5388181,0,0,5388181
2007-11-19,NYSE Arca (P),556916600,239441300,343239557,1139597457,0.0,0.0,0.0,0.0,3130066,518053,1522685,5170804
2007-11-19,Nasdaq (Q),818509258,308341898,1111214377,2238065533,0.0,0.0,0.0,0.0,4299812,772226,4383498,9455536
2007-11-19,CBOE (W),1417900,3772300,1437200,6627400,0.0,0.0,0.0,0.0,1467,1323,456,3246
2007-11-19,PHLX (X),4961300,289300,1799182,7049782,0.0,0.0,0.0,0.0,2657,103,3483,6243
2007-11-20,AMEX (A),2703400,47505689,75200,50284289,0.0,0.0,0.0,0.0,3362,81421,58,84841
2007-11-20,NSX (C),5804211,17363163,20475588,43642962,0.0,0.0,0.0,0.0,30380,33884,94812,159076
2007-11-20,NSX (DC),7053759,5391767,62493611,74939137,0.0,0.0,0.0,0.0,29427,4964,185495,219886
2007-11-20,NYSE (DN),205553700,71923900,214186467,491664067,0.0,0.0,0.0,0.0,1283659,181698,1052289,2517646
2007-11-20,Nasdaq (DQ),862786330,215259183,558336418,1636381931,0.0,0.0,0.0,0.0,954673,82359,584778,1621810
2007-11-20,ADF (D),131841800,36153420,115753000,283748220,0.0,0.0,0.0,0.0,458081,56934,355907,870922
2007-11-20,ISE (I),76741800,1484300,2649100,80875200,0.0,0.0,0.0,0.0,445146,1815,6783,453744
2007-11-20,CHX (M),23843300,6512400,11820769,42176469,0.0,0.0,0.0,0.0,28903,2265,8906,40074
2007-11-20,NYSE (N),1864575650,0,0,1864575650,0.0,0.0,0.0,0.0,6295419,0,0,6295419
2007-11-20,NYSE Arca (P),709404900,326102000,420253503,1455760403,0.0,0.0,0.0,0.0,4031474,647973,1780186,6459633
2007-11-20,Nasdaq (Q),1032294399,400335490,1306960133,2739590022,0.0,0.0,0.0,0.0,5459232,949872,5173000,11582104
2007-11-20,CBOE (W),6663700,6475200,3090100,16229000,0.0,0.0,0.0,0.0,4949,2567,1356,8872
2007-11-20,PHLX (X),4557400,488900,1556205,6602505,0.0,0.0,0.0,0.0,2334,383,3223,5940
2007-11-21,AMEX (A),1937000,43751892,1200,45690092,0.0,0.0,0.0,0.0,2025,73869,3,75897
2007-11-21,NSX (C),5033812,9220669,14600561,28855042,0.0,0.0,0.0,0.0,25118,22473,77567,125158
2007-11-21,NSX (DC),7201487,4190426,66577165,77969078,0.0,0.0,0.0,0.0,31071,4206,217218,252495
2007-11-21,NYSE (DN),179676300,61770700,171225698,412672698,0.0,0.0,0.0,0.0,1097891,167530,853728,2119149
2007-11-21,Nasdaq (DQ),722024320,136461896,437780939,1296267155,0.0,0.0,0.0,0.0,810735,75173,473865,1359773
2007-11-21,ADF (D),119644400,28815910,74263000,222723310,0.0,0.0,0.0,0.0,434632,50838,230899,716369
2007-11-21,ISE (I),66988600,1042600,2135900,70167100,0.0,0.0,0.0,0.0,384006,1235,6035,391276
2007-11-21,CHX (M),23106300,3141400,7481106,33728806,0.0,0.0,0.0,0.0,26819,1468,7090,35377
2007-11-21,NYSE (N),1608347430,0,0,1608347430,0.0,0.0,0.0,0.0,5350353,0,0,5350353
2007-11-21,NYSE Arca (P),578848200,232338700,332559053,1143745953,0.0,0.0,0.0,0.0,3251868,534547,1395864,5182279
2007-11-21,Nasdaq (Q),820647158,304283806,1011166162,2136097126,0.0,0.0,0.0,0.0,4353412,793778,4073571,9220761
2007-11-21,CBOE (W),4282100,6750800,987200,12020100,0.0,0.0,0.0,0.0,5155,954,1199,7308
2007-11-21,PHLX (X),3971300,147300,1513676,5632276,0.0,0.0,0.0,0.0,1860,62,2181,4103
2007-11-23,AMEX (A),583800,20371864,336600,21292264,0.0,0.0,0.0,0.0,590,30837,217,31644
2007-11-23,NSX (C),2135585,3202365,5164561,10502511,0.0,0.0,0.0,0.0,11740,6989,25632,44361
2007-11-23,NSX (DC),3284667,1017358,26056523,30358548,0.0,0.0,0.0,0.0,13122,1244,82004,96370
2007-11-23,NYSE (DN),57178900,23761300,58954239,139894439,0.0,0.0,0.0,0.0,341252,59423,310768,711443
2007-11-23,Nasdaq (DQ),286598080,69610238,188106122,544314440,0.0,0.0,0.0,0.0,324258,40087,214301,578646
2007-11-23,ADF (D),46262700,13710700,40037300,100010700,0.0,0.0,0.0,0.0,155410,22341,96001,273752
2007-11-23,ISE (I),20975000,425500,803600,22204100,0.0,0.0,0.0,0.0,125253,377,1995,127625
2007-11-23,CHX (M),7723500,1254600,1350070,10328170,0.0,0.0,0.0,0.0,9508,479,3234,13221
2007-11-23,NYSE (N),669450320,0,0,669450320,0.0,0.0,0.0,0.0,2094735,0,0,2094735
2007-11-23,NYSE Arca (P),183476700,93659300,116094254,393230254,0.0,0.0,0.0,0.0,1015137,194411,526950,1736498
2007-11-23,Nasdaq (Q),287537533,107685265,392632048,787854846,0.0,0.0,0.0,0.0,1508701,273468,1515576,3297745
2007-11-23,CBOE (W),249000,927600,227700,1404300,0.0,0.0,0.0,0.0,544,497,253,1294
2007-11-23,PHLX (X),1432300,200600,334877,1967777,0.0,0.0,0.0,0.0,976,82,1356,2414
2007-11-26,AMEX (A),2372100,46214027,138600,48724727,0.0,0.0,0.0,0.0,2375,83522,89,85986
2007-11-26,NSX (C),43313948,3984263,14663146,61961357,0.0,0.0,0.0,0.0,269317,9528,71651,350496
2007-11-26,NSX (DC),7957230,3867023,67963978,79788231,0.0,0.0,0.0,0.0,28734,3010,213270,245014
2007-11-26,NYSE (DN),168688700,55735300,169245001,393669001,0.0,0.0,0.0,0.0,1050464,145277,844316,2040057
2007-11-26,Nasdaq (DQ),620990920,164483950,422331333,1207806203,0.0,0.0,0.0,0.0,818226,79394,487544,1385164
2007-11-26,ADF (D),105751700,29518400,80001500,215271600,0.0,0.0,0.0,0.0,349397,51086,242741,643224
2007-11-26,ISE (I),5196000,5833300,2163500,13192800,0.0,0.0,0.0,0.0,15502,14129,6287,35918
2007-11-26,CHX (M),19895653,3178900,16102245,39176798,0.0,0.0,0.0,0.0,25383,2288,11233,38904
2007-11-26,NYSE (N),1501546320,0,0,1501546320,0.0,0.0,0.0,0.0,4805600,0,0,4805600
2007-11-26,NYSE Arca (P),509097900,212819100,314103857,1036020857,0.0,0.0,0.0,0.0,2975214,496060,1373502,4844776
2007-11-26,Nasdaq (Q),735989579,274891727,997986387,2008867693,0.0,0.0,0.0,0.0,3981447,710446,3854165,8546058
2007-11-26,CBOE (W),3631700,3469000,2028300,9129000,0.0,0.0,0.0,0.0,3759,2215,808,6782
2007-11-26,PHLX (X),5034700,563700,1768062,7366462,0.0,0.0,0.0,0.0,1858,456,3060,5374
2007-11-27,AMEX (A),2370400,45258643,3500,47632543,0.0,0.0,0.0,0.0,2765,81515,2,84282
2007-11-27,NSX (C),44815445,4035954,15454438,64305837,0.0,0.0,0.0,0.0,273424,10124,73744,357292
2007-11-27,NSX (DC),9403447,3547442,106650622,119601511,0.0,0.0,0.0,0.0,35608,3914,335887,375409
2007-11-27,NYSE (DN),213931200,66104300,185940343,465975843,0.0,0.0,0.0,0.0,1291951,167617,928306,2387874
2007-11-27,Nasdaq (DQ),733542260,159129142,453118836,1345790238,0.0,0.0,0.0,0.0,888908,82425,516248,1487581
2007-11-27,ADF (D),114186800,31176400,53757500,199120700,0.0,0.0,0.0,0.0,407160,57474,156334,620968
2007-11-27,ISE (I),17416200,9802200,7514300,34732700,0.0,0.0,0.0,0.0,87230,20041,23725,130996
2007-11-27,CHX (M),30343534,4584910,7242326,42170770,0.0,0.0,0.0,0.0,24454,3031,7902,35387
2007-11-27,NYSE (N),1653303550,0,0,1653303550,0.0,0.0,0.0,0.0,5353227,0,0,5353227
2007-11-27,NYSE Arca (P),620252500,235777300,353849941,1209879741,0.0,0.0,0.0,0.0,3555171,536462,1515785,5607418
2007-11-27,Nasdaq (Q),872087933,325689445,1102879472,2300656850,0.0,0.0,0.0,0.0,4687026,838814,4348359,9874199
2007-11-27,CBOE (W),3377600,2653600,1230100,7261300,0.0,0.0,0.0,0.0,2763,1396,1065,5224
2007-11-27,PHLX (X),5025100,272800,1120392,6418292,0.0,0.0,0.0,0.0,2330,479,3597,6406
2007-11-28,AMEX (A),5929300,46867757,123200,52920257,0.0,0.0,0.0,0.0,3515,83051,36,86602
2007-11-28,NSX (C),55370027,3897344,19268295,78535666,0.0,0.0,0.0,0.0,339278,9207,85692,434177
2007-11-28,NSX (DC),11074273,4850266,125748398,141672937,0.0,0.0,0.0,0.0,39618,5070,361331,406019
2007-11-28,NYSE (DN),205720200,71841400,204721041,482282641,0.0,0.0,0.0,0.0,1274772,162933,999893,2437598
2007-11-28,Nasdaq (DQ),841846190,154991772,563817298,1560655260,0.0,0.0,0.0,0.0,896869,89091,553477,1539437
2007-11-28,ADF (D),131383400,35702700,56614000,223700100,0.0,0.0,0.0,0.0,440664,62430,162389,665483
2007-11-28,ISE (I),9094100,10842400,4145200,24081700,0.0,0.0,0.0,0.0,35526,20403,12092,68021
2007-11-28,CHX (M),21580855,5612700,9704532,36898087,0.0,0.0,0.0,0.0,25425,1492,8490,35407
2007-11-28,NYSE (N),1760090270,0,0,1760090270,0.0,0.0,0.0,0.0,5448516,0,0,5448516
2007-11-28,NYSE Arca (P),658534900,269028500,398698822,1326262222,0.0,0.0,0.0,0.0,3738448,579349,1709747,6027544
2007-11-28,Nasdaq (Q),900391453,346320624,1212594079,2459306156,0.0,0.0,0.0,0.0,4706221,809783,4586497,10102501
2007-11-28,CBOE (W),3016900,3380700,3118300,9515900,0.0,0.0,0.0,0.0,4826,1362,1667,7855
2007-11-28,PHLX (X),3049600,314700,3096182,6460482,0.0,0.0,0.0,0.0,2147,276,4016,6439
2007-11-29,AMEX (A),1297300,23467195,1800,24766295,0.0,0.0,0.0,0.0,1474,43476,2,44952
2007-11-29,NSX (C),44256611,2536980,16498498,63292089,0.0,0.0,0.0,0.0,279969,6470,72930,359369
2007-11-29,NSX (DC),8119587,2156041,273765845,284041473,0.0,0.0,0.0,0.0,31624,3455,1158967,1194046
2007-11-29,NYSE (DN),159241300,51442700,0,210684000,0.0,0.0,0.0,0.0,1030519,133036,0,1163555
2007-11-29,Nasdaq (DQ),667524540,106697233,495098845,1269320618,0.0,0.0,0.0,0.0,819970,60343,516103,1396416
2007-11-29,ADF (D),88068000,25321100,55105700,168494800,0.0,0.0,0.0,0.0,311351,45222,140393,496966
2007-11-29,ISE (I),4509000,6853500,2452800,13815300,0.0,0.0,0.0,0.0,13634,16883,6322,36839
2007-11-29,CHX (M),22417910,5082700,6183699,33684309,0.0,0.0,0.0,0.0,25166,1440,7101,33707
2007-11-29,NYSE (N),1333032050,0,0,1333032050,0.0,0.0,0.0,0.0,4535853,0,0,4535853
2007-11-29,NYSE Arca (P),508598400,187495800,343603256,1039697456,0.0,0.0,0.0,0.0,2997448,457417,1413965,4868830
2007-11-29,Nasdaq (Q),689420893,263515446,1018648602,1971584941,0.0,0.0,0.0,0.0,3774474,708378,3880823,8363675
2007-11-29,CBOE (W),4520300,1464000,1221300,7205600,0.0,0.0,0.0,0.0,4048,915,998,5961
2007-11-29,PHLX (X),5869700,192400,2535518,8597618,0.0,0.0,0.0,0.0,1265,168,2723,4156
2007-11-30,AMEX (A),2318500,42940646,2800,45261946,0.0,0.0,0.0,0.0,1948,73696,4,75648
2007-11-30,NSX (C),46914317,2907076,18928406,68749799,0.0,0.0,0.0,0.0,294405,5530,87881,387816
2007-11-30,NSX (DC),9035236,2931951,315708390,327675577,0.0,0.0,0.0,0.0,31014,4468,1300739,1336221
2007-11-30,NYSE (DN),191061900,58087100,38037938,287186938,0.0,0.0,0.0,0.0,1202575,152017,182052,1536644
2007-11-30,Nasdaq (DQ),751037040,129798535,578219879,1459055454,0.0,0.0,0.0,0.0,888164,86511,579664,1554339
2007-11-30,ADF (D),124126000,31320080,41973400,197419480,0.0,0.0,0.0,0.0,433890,60495,109241,603626
2007-11-30,ISE (I),7004600,7375000,3537600,17917200,0.0,0.0,0.0,0.0,20218,17502,10103,47823
2007-11-30,CHX (M),21854900,9207900,7788576,38851376,0.0,0.0,0.0,0.0,25846,1961,8478,36285
2007-11-30,NYSE (N),1914078970,0,0,1914078970,0.0,0.0,0.0,0.0,5011530,0,0,5011530
2007-11-30,NYSE Arca (P),557397600,224344000,385988859,1167730459,0.0,0.0,0.0,0.0,3185603,492105,1604199,5281907
2007-11-30,Nasdaq (Q),777917143,296869432,1399846475,2474633050,0.0,0.0,0.0,0.0,4114957,760061,4316209,9191227
2007-11-30,CBOE (W),3487000,3583600,1398600,8469200,0.0,0.0,0.0,0.0,4051,1432,1076,6559
2007-11-30,PHLX (X),4352600,156300,1881096,6389996,0.0,0.0,0.0,0.0,1914,55,3805,5774
2007-12-03,AMEX (A),1393600,36919402,0,38313002,0.0,0.0,0.0,0.0,1529,60775,0,62304
2007-12-03,NSX (C),5583910,5139798,14610558,25334266,0.0,0.0,0.0,0.0,29514,12974,72467,114955
2007-12-03,NSX (DC),5935818,2169544,287251762,295357124,0.0,0.0,0.0,0.0,23010,3535,1200438,1226983
2007-12-03,NYSE (DN),148140100,36900800,220463,185261363,0.0,0.0,0.0,0.0,913801,104889,1488,1020178
2007-12-03,Nasdaq (DQ),557345710,89306983,448729667,1095382360,0.0,0.0,0.0,0.0,743771,59893,493190,1296854
2007-12-03,ADF (D),97028150,21711800,34581100,153321050,0.0,0.0,0.0,0.0,345912,44583,93073,483568
2007-12-03,ISE (I),50711800,279700,2242400,53233900,0.0,0.0,0.0,0.0,307449,514,5709,313672
2007-12-03,CHX (M),22999531,4754500,9339049,37093080,0.0,0.0,0.0,0.0,23521,1234,6933,31688
2007-12-03,NYSE (N),1330838800,0,0,1330838800,0.0,0.0,0.0,0.0,4336621,0,0,4336621
2007-12-03,NYSE Arca (P),463013669,146018053,310618393,919650115,0.0,0.0,0.0,0.0,2651105,368773,1346643,4366521
2007-12-03,Nasdaq (Q),640534887,198563023,941931273,1781029183,0.0,0.0,0.0,0.0,3419858,560981,3711785,7692624
2007-12-03,CBOE (W),2748300,2366400,1159300,6274000,0.0,0.0,0.0,0.0,3336,974,961,5271
2007-12-03,PHLX (X),2479800,3185100,8726884,14391784,0.0,0.0,0.0,0.0,1621,43,3373,5037
2007-12-04,AMEX (A),1729000,34777034,0,36506034,0.0,0.0,0.0,0.0,1855,62408,0,64263
2007-12-04,NSX (C),4015771,4377903,17100471,25494145,0.0,0.0,0.0,0.0,21586,12410,79166,113162
2007-12-04,NSX (DC),6209817,2683115,289779969,298672901,0.0,0.0,0.0,0.0,22557,3824,1215924,1242305
2007-12-04,NYSE (DN),135974100,37930200,553831,174458131,0.0,0.0,0.0,0.0,885293,105345,3427,994065
2007-12-04,Nasdaq (DQ),603705830,94123039,517067328,1214896197,0.0,0.0,0.0,0.0,807126,56702,521622,1385450
2007-12-04,ADF (D),94925900,21079700,36190300,152195900,0.0,0.0,0.0,0.0,332150,40278,101867,474295
2007-12-04,ISE (I),47577600,557100,2238800,50373500,0.0,0.0,0.0,0.0,299260,816,6815,306891
2007-12-04,CHX (M),18938200,5330200,6211311,30479711,0.0,0.0,0.0,0.0,22387,1078,6620,30085
2007-12-04,NYSE (N),1332046090,0,0,1332046090,0.0,0.0,0.0,0.0,4278631,0,0,4278631
2007-12-04,NYSE Arca (P),463361789,141618745,321357100,926337634,0.0,0.0,0.0,0.0,2628740,344472,1372267,4345479
2007-12-04,Nasdaq (Q),621369082,196822607,949373560,1767565249,0.0,0.0,0.0,0.0,3333021,539907,3627964,7500892
2007-12-04,CBOE (W),2322500,3020500,2404000,7747000,0.0,0.0,0.0,0.0,3335,1147,1037,5519
2007-12-04,PHLX (X),3229700,653100,1307314,5190114,0.0,0.0,0.0,0.0,1645,101,3037,4783
2007-12-05,AMEX (A),1339300,37572063,8000,38919363,0.0,0.0,0.0,0.0,1848,67874,4,69726
2007-12-05,NSX (C),4823635,6327494,16775120,27926249,0.0,0.0,0.0,0.0,24067,15009,77978,117054
2007-12-05,NSX (DC),6365535,2199353,297767234,306332122,0.0,0.0,0.0,0.0,22919,3490,1191792,1218201
2007-12-05,NYSE (DN),147835300,42613300,584847,191033447,0.0,0.0,0.0,0.0,933787,112735,3609,1050131
2007-12-05,Nasdaq (DQ),682749500,111979614,524289716,1319018830,0.0,0.0,0.0,0.0,833431,66414,546041,1445886
2007-12-05,ADF (D),94491520,21467600,40031700,155990820,0.0,0.0,0.0,0.0,322228,38772,91798,452798
2007-12-05,ISE (I),62501900,686000,3670200,66858100,0.0,0.0,0.0,0.0,376684,667,7895,385246
2007-12-05,CHX (M),24257200,3299500,7361907,34918607,0.0,0.0,0.0,0.0,23226,1376,7109,31711
2007-12-05,NYSE (N),1431031190,0,0,1431031190,0.0,0.0,0.0,0.0,4493474,0,0,4493474
2007-12-05,NYSE Arca (P),508302492,181057436,345742537,1035102465,0.0,0.0,0.0,0.0,2815148,396632,1426769,4638549
2007-12-05,Nasdaq (Q),724428814,230050134,1095632051,2050110999,0.0,0.0,0.0,0.0,3776024,613537,4007227,8396788
2007-12-05,CBOE (W),2974900,3118300,4153500,10246700,0.0,0.0,0.0,0.0,3880,1057,1064,6001
2007-12-05,PHLX (X),5105200,706400,1645052,7456652,0.0,0.0,0.0,0.0,6359,117,4231,10707
2007-12-06,AMEX (A),250600,42527373,0,42777973,0.0,0.0,0.0,0.0,377,74949,0,75326
2007-12-06,NSX (C),4391420,5301200,14917896,24610516,0.0,0.0,0.0,0.0,20790,15738,70006,106534
2007-12-06,NSX (DC),7030040,2727928,288925923,298683891,0.0,0.0,0.0,0.0,25626,3393,1179089,1208108
2007-12-06,NYSE (DN),126650600,55559600,331337,182541537,0.0,0.0,0.0,0.0,828544,162390,2160,993094
2007-12-06,Nasdaq (DQ),633937040,121058729,488657207,1243652976,0.0,0.0,0.0,0.0,842212,85068,552521,1479801
2007-12-06,ADF (D),134152920,37780000,40810100,212743020,0.0,0.0,0.0,0.0,449221,70071,105195,624487
2007-12-06,ISE (I),49796300,664600,2691100,53152000,0.0,0.0,0.0,0.0,310082,805,7187,318074
2007-12-06,CHX (M),22103950,4469900,7742920,34316770,0.0,0.0,0.0,0.0,33164,1145,6953,41262
2007-12-06,NYSE (N),1368904200,0,0,1368904200,0.0,0.0,0.0,0.0,4403164,0,0,4403164
2007-12-06,NYSE Arca (P),441029888,254851968,298137249,994019105,0.0,0.0,0.0,0.0,2615658,576157,1308424,4500239
2007-12-06,Nasdaq (Q),654814288,261631183,923558376,1840003847,0.0,0.0,0.0,0.0,3538513,735326,3720913,7994752
2007-12-06,CBOE (W),6189200,3710200,3252300,13151700,0.0,0.0,0.0,0.0,3744,1579,1129,6452
2007-12-06,PHLX (X),7882700,146800,1386779,9416279,0.0,0.0,0.0,0.0,8745,95,2732,11572
2007-12-07,AMEX (A),81300,44957735,5100,45044135,0.0,0.0,0.0,0.0,91,66267,2,66360
2007-12-07,NSX (C),34443625,6162225,12307300,52913150,0.0,0.0,0.0,0.0,217932,16037,59333,293302
2007-12-07,NSX (DC),30567743,7895164,134983883,173446790,0.0,0.0,0.0,0.0,167476,20400,466858,654734
2007-12-07,NYSE (DN),98052000,35736900,109717024,243505924,0.0,0.0,0.0,0.0,638165,116388,578200,1332753
2007-12-07,Nasdaq (DQ),618670610,178845904,534013431,1331529945,0.0,0.0,0.0,0.0,728472,71836,488337,1288645
2007-12-07,ADF (D),102277610,26236800,34240400,162754810,0.0,0.0,0.0,0.0,352427,51957,88977,493361
2007-12-07,ISE (I),4324600,1056600,2597700,7978900,0.0,0.0,0.0,0.0,14133,1220,7262,22615
2007-12-07,CHX (M),17101810,3753350,5726442,26581602,0.0,0.0,0.0,0.0,20726,1762,7888,30376
2007-12-07,NYSE (N),1204018690,0,0,1204018690,0.0,0.0,0.0,0.0,3899468,0,0,3899468
2007-12-07,NYSE Arca (P),381696507,187328262,286089643,855114412,0.0,0.0,0.0,0.0,2295556,464637,1231033,3991226
2007-12-07,Nasdaq (Q),551357206,208304824,850740922,1610402952,0.0,0.0,0.0,0.0,2994843,606368,3368329,6969540
2007-12-07,CBOE (W),2886100,2699200,2118900,7704200,0.0,0.0,0.0,0.0,2434,1303,1007,4744
2007-12-07,PHLX (X),3788400,603900,1760907,6153207,0.0,0.0,0.0,0.0,4253,374,3024,7651
2007-12-10,AMEX (A),84700,37718189,4000,37806889,0.0,0.0,0.0,0.0,82,61704,8,61794
2007-12-10,NSX (C),35505953,1562192,13750407,50818552,0.0,0.0,0.0,0.0,222892,4266,70367,297525
2007-12-10,NSX (DC),6829071,2385114,113527142,122741327,0.0,0.0,0.0,0.0,26717,3795,372328,402840
2007-12-10,NYSE (DN),116868200,37669300,131176817,285714317,0.0,0.0,0.0,0.0,737883,116249,688971,1543103
2007-12-10,Nasdaq (DQ),548563920,117541594,460812112,1126917626,0.0,0.0,0.0,0.0,759141,73986,519627,1352754
2007-12-10,ADF (D),107506120,27216280,36565400,171287800,0.0,0.0,0.0,0.0,371728,51201,111226,534155
2007-12-10,ISE (I),4281600,4753300,3273300,12308200,0.0,0.0,0.0,0.0,14844,12665,8625,36134
2007-12-10,CHX (M),17763800,4282600,5462551,27508951,0.0,0.0,0.0,0.0,23417,909,6971,31297
2007-12-10,NYSE (N),1171843670,0,0,1171843670,0.0,0.0,0.0,0.0,3750280,0,0,3750280
2007-12-10,NYSE Arca (P),367701763,172013127,266764574,806479464,0.0,0.0,0.0,0.0,2175712,420463,1202564,3798739
2007-12-10,Nasdaq (Q),523323228,190007809,843964538,1557295575,0.0,0.0,0.0,0.0,2808370,550193,3353342,6711905
2007-12-10,CBOE (W),3253300,1446100,2044400,6743800,0.0,0.0,0.0,0.0,2676,986,1338,5000
2007-12-10,PHLX (X),3514600,107000,1115208,4736808,0.0,0.0,0.0,0.0,4758,43,2573,7374
2007-12-11,AMEX (A),215300,51633288,1000,51849588,0.0,0.0,0.0,0.0,215,79975,2,80192
2007-12-11,NSX (C),52552286,2334850,16929462,71816598,0.0,0.0,0.0,0.0,324466,5632,85947,416045
2007-12-11,NSX (DC),10289981,3452223,113552324,127294528,0.0,0.0,0.0,0.0,34295,4079,372262,410636
2007-12-11,NYSE (DN),181073300,75251200,170038778,426363278,0.0,0.0,0.0,0.0,1146680,216145,871871,2234696
2007-12-11,Nasdaq (DQ),662273950,168181654,476871462,1307327066,0.0,0.0,0.0,0.0,889785,91431,553043,1534259
2007-12-11,ADF (D),121420610,28340400,35497100,185258110,0.0,0.0,0.0,0.0,435983,55073,114225,605281
2007-12-11,ISE (I),5707700,11488600,2572200,19768500,0.0,0.0,0.0,0.0,17624,26607,8981,53212
2007-12-11,CHX (M),19442550,4056300,8332314,31831164,0.0,0.0,0.0,0.0,30767,1372,9497,41636
2007-12-11,NYSE (N),1548735290,0,0,1548735290,0.0,0.0,0.0,0.0,4955754,0,0,4955754
2007-12-11,NYSE Arca (P),566662865,330067377,362080412,1258810654,0.0,0.0,0.0,0.0,3320298,744765,1556652,5621715
2007-12-11,Nasdaq (Q),891122285,372693076,1122357010,2386172371,0.0,0.0,0.0,0.0,4660483,1018087,4341295,10019865
2007-12-11,CBOE (W),1936500,3980700,2125300,8042500,0.0,0.0,0.0,0.0,4695,1959,1988,8642
2007-12-11,PHLX (X),5884100,254700,1705411,7844211,0.0,0.0,0.0,0.0,3184,75,2875,6134
2007-12-12,AMEX (A),70600,51897918,1000,51969518,0.0,0.0,0.0,0.0,79,72758,1,72838
2007-12-12,NSX (C),54504800,4626767,17072214,76203781,0.0,0.0,0.0,0.0,345842,9317,83393,438552
2007-12-12,NSX (DC),9171077,3302251,124496984,136970312,0.0,0.0,0.0,0.0,32896,4070,402188,439154
2007-12-12,NYSE (DN),194814500,82713600,178709576,456237676,0.0,0.0,0.0,0.0,1246798,254011,924464,2425273
2007-12-12,Nasdaq (DQ),794991470,196321626,523493051,1514806147,0.0,0.0,0.0,0.0,951971,88732,546752,1587455
2007-12-12,ADF (D),130055140,34081800,34836900,198973840,0.0,0.0,0.0,0.0,454589,62251,111634,628474
2007-12-12,ISE (I),5945000,11074731,2305400,19325131,0.0,0.0,0.0,0.0,16289,24919,7464,48672
2007-12-12,CHX (M),25440200,5764800,7363418,38568418,0.0,0.0,0.0,0.0,26850,1993,8968,37811
2007-12-12,NYSE (N),1725290120,0,0,1725290120,0.0,0.0,0.0,0.0,5745290,0,0,5745290
2007-12-12,NYSE Arca (P),613493290,336193923,361606158,1311293371,0.0,0.0,0.0,0.0,3658809,793892,1542056,5994757
2007-12-12,Nasdaq (Q),902022496,385530892,1130211677,2417765065,0.0,0.0,0.0,0.0,4898353,1058431,4568817,10525601
2007-12-12,CBOE (W),8441600,5715700,1795800,15953100,0.0,0.0,0.0,0.0,5134,1752,1697,8583
2007-12-12,PHLX (X),4555600,444700,1448729,6449029,0.0,0.0,0.0,0.0,1863,179,3254,5296
2007-12-13,AMEX (A),71700,37493567,0,37565267,0.0,0.0,0.0,0.0,58,67921,0,67979
2007-12-13,NSX (C),44596596,2120866,16464885,63182347,0.0,0.0,0.0,0.0,298654,5344,83740,387738
2007-12-13,NSX (DC),8267518,2517664,139578801,150363983,0.0,0.0,0.0,0.0,26525,3532,428854,458911
2007-12-13,NYSE (DN),149954800,68030200,155613387,373598387,0.0,0.0,0.0,0.0,1032289,217973,834246,2084508
2007-12-13,Nasdaq (DQ),634199980,160325080,489461669,1283986729,0.0,0.0,0.0,0.0,836578,85986,524347,1446911
2007-12-13,ADF (D),108016300,32919500,12824300,153760100,0.0,0.0,0.0,0.0,369658,61828,44066,475552
2007-12-13,ISE (I),5573100,9527200,2807700,17908000,0.0,0.0,0.0,0.0,18519,25606,7820,51945
2007-12-13,CHX (M),18932510,6047600,8672834,33652944,0.0,0.0,0.0,0.0,20404,1684,7525,29613
2007-12-13,NYSE (N),1460961480,0,0,1460961480,0.0,0.0,0.0,0.0,4770542,0,0,4770542
2007-12-13,NYSE Arca (P),469299642,280355296,339746824,1089401762,0.0,0.0,0.0,0.0,2865474,682479,1453903,5001856
2007-12-13,Nasdaq (Q),717009704,340035964,1052353592,2109399260,0.0,0.0,0.0,0.0,4023905,940415,4211845,9176165
2007-12-13,CBOE (W),3430100,1803900,1123900,6357900,0.0,0.0,0.0,0.0,3805,1273,1524,6602
2007-12-13,PHLX (X),4388900,582100,877878,5848878,0.0,0.0,0.0,0.0,2646,140,2259,5045
2007-12-14,AMEX (A),3700,39248210,11800,39263710,0.0,0.0,0.0,0.0,7,61525,2,61534
2007-12-14,NSX (C),7863053,6224493,14956739,29044285,0.0,0.0,0.0,0.0,47664,17155,77668,142487
2007-12-14,NSX (DC),5071084,2373913,117502348,124947345,0.0,0.0,0.0,0.0,17842,3369,352147,373358
2007-12-14,NYSE (DN),161391900,52998700,141852664,356243264,0.0,0.0,0.0,0.0,1068420,167525,736435,1972380
2007-12-14,Nasdaq (DQ),651323410,118173961,449068455,1218565826,0.0,0.0,0.0,0.0,836645,73245,539575,1449465
2007-12-14,ADF (D),82646600,22073500,9675400,114395500,0.0,0.0,0.0,0.0,276555,42675,29586,348816
2007-12-14,ISE (I),53821900,756800,2902700,57481400,0.0,0.0,0.0,0.0,345826,1721,8050,355597
2007-12-14,CHX (M),15852440,3878900,8913019,28644359,0.0,0.0,0.0,0.0,21607,1105,8456,31168
2007-12-14,NYSE (N),1304944070,0,0,1304944070,0.0,0.0,0.0,0.0,4184732,0,0,4184732
2007-12-14,NYSE Arca (P),453624052,217667826,295129577,966421455,0.0,0.0,0.0,0.0,2753692,539805,1284298,4577795
2007-12-14,Nasdaq (Q),642142327,249213281,966195828,1857551436,0.0,0.0,0.0,0.0,3548701,712497,3790828,8052026
2007-12-14,CBOE (W),2787000,1490000,1401500,5678500,0.0,0.0,0.0,0.0,3419,920,1429,5768
2007-12-14,PHLX (X),4478900,195700,1268257,5942857,0.0,0.0,0.0,0.0,2559,55,1828,4442
2007-12-17,AMEX (A),1100,43036248,11400,43048748,0.0,0.0,0.0,0.0,2,70011,9,70022
2007-12-17,NSX (C),4416563,5234257,14602985,24253805,0.0,0.0,0.0,0.0,25064,15114,69119,109297
2007-12-17,NSX (DC),7272963,2864434,133766469,143903866,0.0,0.0,0.0,0.0,25398,3801,426024,455223
2007-12-17,NYSE (DN),152469500,53100700,143502229,349072429,0.0,0.0,0.0,0.0,1034086,174860,755302,1964248
2007-12-17,Nasdaq (DQ),647743400,129990727,439608018,1217342145,0.0,0.0,0.0,0.0,844934,91404,518391,1454729
2007-12-17,ADF (D),102056510,31138350,12612500,145807360,0.0,0.0,0.0,0.0,361456,64449,38074,463979
2007-12-17,ISE (I),57304600,2099600,7124200,66528400,0.0,0.0,0.0,0.0,357383,5267,29562,392212
2007-12-17,CHX (M),18374532,3356200,5549834,27280566,0.0,0.0,0.0,0.0,22448,1324,8166,31938
2007-12-17,NYSE (N),1436421260,0,0,1436421260,0.0,0.0,0.0,0.0,4707587,0,0,4707587
2007-12-17,NYSE Arca (P),459809016,228495785,289087070,977391871,0.0,0.0,0.0,0.0,2790347,606395,1264567,4661309
2007-12-17,Nasdaq (Q),666546811,275646498,941748296,1883941605,0.0,0.0,0.0,0.0,3698592,786101,3750721,8235414
2007-12-17,CBOE (W),2510300,3767500,1844100,8121900,0.0,0.0,0.0,0.0,3383,1571,1164,6118
2007-12-17,PHLX (X),6413600,321400,2643856,9378856,0.0,0.0,0.0,0.0,8401,38,3797,12236
2007-12-18,AMEX (A),6100,43852670,173800,44032570,0.0,0.0,0.0,0.0,3,75527,101,75631
2007-12-18,NSX (C),7940108,8183142,16225028,32348278,0.0,0.0,0.0,0.0,46318,22471,84867,153656
2007-12-18,NSX (DC),8702627,2147029,117037038,127886694,0.0,0.0,0.0,0.0,29087,3688,374215,406990
2007-12-18,NYSE (DN),160581300,74675000,158918445,394174745,0.0,0.0,0.0,0.0,1059367,224308,839902,2123577
2007-12-18,Nasdaq (DQ),711528390,152823266,462085276,1326436932,0.0,0.0,0.0,0.0,856741,91492,549405,1497638
2007-12-18,ADF (D),110608610,32558100,10545100,153711810,0.0,0.0,0.0,0.0,395191,65299,39242,499732
2007-12-18,ISE (I),55135800,867416,2827200,58830416,0.0,0.0,0.0,0.0,345269,1889,9219,356377
2007-12-18,CHX (M),19630152,3099500,8926561,31656213,0.0,0.0,0.0,0.0,22075,1746,7027,30848
2007-12-18,NYSE (N),1491628380,0,0,1491628380,0.0,0.0,0.0,0.0,4901677,0,0,4901677
2007-12-18,NYSE Arca (P),478030900,285918184,316693108,1080642192,0.0,0.0,0.0,0.0,2897529,742865,1386552,5026946
2007-12-18,Nasdaq (Q),686124539,347396310,987964139,2021484988,0.0,0.0,0.0,0.0,3788908,968952,4122289,8880149
2007-12-18,CBOE (W),4677500,4245800,3702000,12625300,0.0,0.0,0.0,0.0,4268,1613,830,6711
2007-12-18,PHLX (X),3823400,236100,1450098,5509598,0.0,0.0,0.0,0.0,4496,39,2577,7112
2007-12-19,AMEX (A),3100,41420980,1900,41425980,0.0,0.0,0.0,0.0,4,66121,5,66130
2007-12-19,NSX (C),5506602,10391963,17576045,33474610,0.0,0.0,0.0,0.0,29863,28079,81279,139221
2007-12-19,NSX (DC),57714835,25777894,173669507,257162236,0.0,0.0,0.0,0.0,362681,73312,646759,1082752
2007-12-19,NYSE (DN),80763100,30767100,82991245,194521445,0.0,0.0,0.0,0.0,523993,105936,407112,1037041
2007-12-19,Nasdaq (DQ),638955640,132740787,428162623,1199859050,0.0,0.0,0.0,0.0,811840,84826,500361,1397027
2007-12-19,ADF (D),110441800,29054890,9298500,148795190,0.0,0.0,0.0,0.0,376206,56615,31673,464494
2007-12-19,ISE (I),56262800,615300,2523300,59401400,0.0,0.0,0.0,0.0,358165,877,8099,367141
2007-12-19,CHX (M),27773843,3475000,7862777,39111620,0.0,0.0,0.0,0.0,21059,1764,8190,31013
2007-12-19,NYSE (N),1353006890,0,0,1353006890,0.0,0.0,0.0,0.0,4461834,0,0,4461834
2007-12-19,NYSE Arca (P),425283009,256862275,297340523,979485807,0.0,0.0,0.0,0.0,2562772,641123,1275279,4479174
2007-12-19,Nasdaq (Q),630815008,290512897,917418306,1838746211,0.0,0.0,0.0,0.0,3552902,837047,3662437,8052386
2007-12-19,CBOE (W),3351400,4490700,2574300,10416400,0.0,0.0,0.0,0.0,3702,1094,798,5594
2007-12-19,PHLX (X),10635400,2401400,2809024,15845824,0.0,0.0,0.0,0.0,3265,62,2504,5831
2007-12-20,AMEX (A),19500,50724534,6400,50750434,0.0,0.0,0.0,0.0,14,70841,4,70859
2007-12-20,NSX (C),4990306,7096033,14987526,27073865,0.0,0.0,0.0,0.0,27096,19588,73191,119875
2007-12-20,NSX (DC),16208668,1966947,123075847,141251462,0.0,0.0,0.0,0.0,54476,2829,372483,429788
2007-12-20,NYSE (DN),131808500,50227700,147556085,329592285,0.0,0.0,0.0,0.0,874139,158021,751568,1783728
2007-12-20,Nasdaq (DQ),694567400,195677768,478096199,1368341367,0.0,0.0,0.0,0.0,855499,72602,544202,1472303
2007-12-20,ADF (D),111607700,26013600,10455200,148076500,0.0,0.0,0.0,0.0,368744,46597,36880,452221
2007-12-20,ISE (I),53379900,571800,2684900,56636600,0.0,0.0,0.0,0.0,342458,904,8018,351380
2007-12-20,CHX (M),22404403,7535530,7334638,37274571,0.0,0.0,0.0,0.0,23570,1487,8043,33100
2007-12-20,NYSE (N),1382041810,0,0,1382041810,0.0,0.0,0.0,0.0,4324922,0,0,4324922
2007-12-20,NYSE Arca (P),460790130,232645959,318195437,1011631526,0.0,0.0,0.0,0.0,2629917,577123,1339808,4546848
2007-12-20,Nasdaq (Q),644253465,263908107,967260005,1875421577,0.0,0.0,0.0,0.0,3431129,738166,3780365,7949660
2007-12-20,CBOE (W),1801500,5352200,1536200,8689900,0.0,0.0,0.0,0.0,3419,2333,752,6504
2007-12-20,PHLX (X),6042500,870100,2102788,9015388,0.0,0.0,0.0,0.0,5383,77,2542,8002
2007-12-21,AMEX (A),10200,62126641,2300,62139141,0.0,0.0,0.0,0.0,7,78281,8,78296
2007-12-21,NSX (C),7324806,6414583,15904798,29644187,0.0,0.0,0.0,0.0,41428,18274,76534,136236
2007-12-21,NSX (DC),44480553,5316067,129114348,178910968,0.0,0.0,0.0,0.0,146310,12460,427406,586176
2007-12-21,NYSE (DN),119748300,45788600,139876478,305413378,0.0,0.0,0.0,0.0,768780,141173,728313,1638266
2007-12-21,Nasdaq (DQ),766221610,148849643,725187282,1640258535,0.0,0.0,0.0,0.0,925939,85986,617200,1629125
2007-12-21,ADF (D),86915410,24700000,10618500,122233910,0.0,0.0,0.0,0.0,306116,44591,37840,388547
2007-12-21,ISE (I),45144500,547300,2368900,48060700,0.0,0.0,0.0,0.0,282522,670,7498,290690
2007-12-21,CHX (M),23487430,7225200,7692404,38405034,0.0,0.0,0.0,0.0,22996,1427,8326,32749
2007-12-21,NYSE (N),2327062100,0,0,2327062100,0.0,0.0,0.0,0.0,4260822,0,0,4260822
2007-12-21,NYSE Arca (P),434379964,225038124,319914785,979332873,0.0,0.0,0.0,0.0,2396416,521461,1398425,4316302
2007-12-21,Nasdaq (Q),623636892,239378158,1916265882,2779280932,0.0,0.0,0.0,0.0,3135418,658308,3811326,7605052
2007-12-21,CBOE (W),3237400,6298000,685500,10220900,0.0,0.0,0.0,0.0,3343,1562,817,5722
2007-12-21,PHLX (X),4331000,568600,2522898,7422498,0.0,0.0,0.0,0.0,6007,45,3592,9644
2007-12-24,AMEX (A),1800,22929500,300,22931600,0.0,0.0,0.0,0.0,18,33685,1,33704
2007-12-24,NSX (C),2707627,2407659,5641744,10757030,0.0,0.0,0.0,0.0,14464,6910,28351,49725
2007-12-24,NSX (DC),14347331,1776474,52790443,68914248,0.0,0.0,0.0,0.0,52056,4011,168538,224605
2007-12-24,NYSE (DN),40228600,16583900,51781685,108594185,0.0,0.0,0.0,0.0,267182,49937,287196,604315
2007-12-24,Nasdaq (DQ),234896820,75721766,212963988,523582574,0.0,0.0,0.0,0.0,383382,45079,278295,706756
2007-12-24,ADF (D),36129200,11836700,4584700,52550600,0.0,0.0,0.0,0.0,120010,21361,15896,157267
2007-12-24,ISE (I),17013200,113300,768100,17894600,0.0,0.0,0.0,0.0,111230,243,2609,114082
2007-12-24,CHX (M),11241100,3325100,2097217,16663417,0.0,0.0,0.0,0.0,7923,474,3058,11455
2007-12-24,NYSE (N),535834520,0,0,535834520,0.0,0.0,0.0,0.0,1683050,0,0,1683050
2007-12-24,NYSE Arca (P),141388150,89966464,109189279,340543893,0.0,0.0,0.0,0.0,836706,207369,508146,1552221
2007-12-24,Nasdaq (Q),222504364,89968610,357828041,670301015,0.0,0.0,0.0,0.0,1166326,241337,1413999,2821662
2007-12-24,CBOE (W),427300,2811000,4162100,7400400,0.0,0.0,0.0,0.0,761,1102,422,2285
2007-12-24,PHLX (X),426700,38300,373751,838751,0.0,0.0,0.0,0.0,1079,19,1261,2359
2007-12-26,AMEX (A),400,31655024,0,31655424,0.0,0.0,0.0,0.0,2,53821,0,53823
2007-12-26,NSX (C),3900591,3828663,9949954,17679208,0.0,0.0,0.0,0.0,20423,11027,48912,80362
2007-12-26,NSX (DC),33006089,3240254,88843254,125089597,0.0,0.0,0.0,0.0,108050,7228,262654,377932
2007-12-26,NYSE (DN),74864000,20551800,81448187,176863987,0.0,0.0,0.0,0.0,461285,71120,438258,970663
2007-12-26,Nasdaq (DQ),349408680,74292943,309733416,733435039,0.0,0.0,0.0,0.0,618277,60636,423809,1102722
2007-12-26,ADF (D),56681400,17438020,6126600,80246020,0.0,0.0,0.0,0.0,187519,30971,20925,239415
2007-12-26,ISE (I),30245800,396200,1356800,31998800,0.0,0.0,0.0,0.0,185627,508,4027,190162
2007-12-26,CHX (M),16489060,3316200,6037640,25842900,0.0,0.0,0.0,0.0,12963,962,6227,20152
2007-12-26,NYSE (N),839054840,0,0,839054840,0.0,0.0,0.0,0.0,2773836,0,0,2773836
2007-12-26,NYSE Arca (P),230625600,142084036,174321580,547031216,0.0,0.0,0.0,0.0,1391849,312997,830476,2535322
2007-12-26,Nasdaq (Q),332923038,130495728,590808436,1054227202,0.0,0.0,0.0,0.0,1782333,375431,2452371,4610135
2007-12-26,CBOE (W),7310500,4916900,4628100,16855500,0.0,0.0,0.0,0.0,1661,1945,692,4298
2007-12-26,PHLX (X),4091200,159000,471150,4721350,0.0,0.0,0.0,0.0,3566,51,1673,5290
2007-12-27,AMEX (A),100,39342122,7300,39349522,0.0,0.0,0.0,0.0,1,62959,1,62961
2007-12-27,NSX (C),3934325,5244086,12042089,21220500,0.0,0.0,0.0,0.0,21175,14281,58145,93601
2007-12-27,NSX (DC),53360472,10079489,114822076,178262037,0.0,0.0,0.0,0.0,175800,23138,338297,537235
2007-12-27,NYSE (DN),77800100,30498500,101249448,209548048,0.0,0.0,0.0,0.0,498145,106160,547318,1151623
2007-12-27,Nasdaq (DQ),453095950,115892375,361075369,930063694,0.0,0.0,0.0,0.0,742765,72206,489635,1304606
2007-12-27,ADF (D),52206600,17331000,7421900,76959500,0.0,0.0,0.0,0.0,177162,30621,27350,235133
2007-12-27,ISE (I),31881200,353300,1344100,33578600,0.0,0.0,0.0,0.0,203149,555,4287,207991
2007-12-27,CHX (M),15436800,2828200,4556543,22821543,0.0,0.0,0.0,0.0,14178,845,6486,21509
2007-12-27,NYSE (N),983919760,0,0,983919760,0.0,0.0,0.0,0.0,3242604,0,0,3242604
2007-12-27,NYSE Arca (P),269583580,166757726,206277693,642618999,0.0,0.0,0.0,0.0,1573327,419520,980796,2973643
2007-12-27,Nasdaq (Q),405598066,186949717,690668690,1283216473,0.0,0.0,0.0,0.0,2183817,530620,2726201,5440638
2007-12-27,CBOE (W),1634900,2740800,2966400,7342100,0.0,0.0,0.0,0.0,1954,1923,689,4566
2007-12-27,PHLX (X),3218600,139200,824006,4181806,0.0,0.0,0.0,0.0,3467,61,2107,5635
2007-12-28,AMEX (A),0,33795445,7400,33802845,0.0,0.0,0.0,0.0,0,59478,1,59479
2007-12-28,NSX (C),4307048,6548631,12252358,23108037,0.0,0.0,0.0,0.0,21439,17546,59336,98321
2007-12-28,NSX (DC),113302994,27440388,121505272,262248654,0.0,0.0,0.0,0.0,469118,66132,438840,974090
2007-12-28,NYSE (DN),55557700,20646900,68421934,144626534,0.0,0.0,0.0,0.0,352037,76329,380297,808663
2007-12-28,Nasdaq (DQ),472419240,107469436,350422576,930311252,0.0,0.0,0.0,0.0,715249,77696,459029,1251974
2007-12-28,ADF (D),8033610,1877600,7150600,17061810,0.0,0.0,0.0,0.0,29990,4759,24856,59605
2007-12-28,ISE (I),30650300,284100,1176800,32111200,0.0,0.0,0.0,0.0,195557,478,3557,199592
2007-12-28,CHX (M),15119452,1878500,4387702,21385654,0.0,0.0,0.0,0.0,15638,1190,6846,23674
2007-12-28,NYSE (N),1035600030,0,0,1035600030,0.0,0.0,0.0,0.0,3281224,0,0,3281224
2007-12-28,NYSE Arca (P),273985150,141994846,203314613,619294609,0.0,0.0,0.0,0.0,1570533,385473,956647,2912653
2007-12-28,Nasdaq (Q),401391512,164481959,636720496,1202593967,0.0,0.0,0.0,0.0,2060616,490745,2545311,5096672
2007-12-28,CBOE (W),1030000,3523900,912000,5465900,0.0,0.0,0.0,0.0,2344,1071,679,4094
2007-12-28,PHLX (X),2827600,94900,952396,3874896,0.0,0.0,0.0,0.0,2214,48,2487,4749
2007-12-31,AMEX (A),0,39684877,2200,39687077,0.0,0.0,0.0,0.0,0,64711,1,64712
2007-12-31,NSX (C),3716161,7023319,16633846,27373326,0.0,0.0,0.0,0.0,20248,17753,72637,110638
2007-12-31,NSX (DC),84903759,21574225,97387433,203865417,0.0,0.0,0.0,0.0,275774,41694,289230,606698
2007-12-31,NYSE (DN),71425300,26719300,88876435,187021035,0.0,0.0,0.0,0.0,448803,97397,470871,1017071
2007-12-31,Nasdaq (DQ),470320150,124283306,419283824,1013887280,0.0,0.0,0.0,0.0,770506,82756,509884,1363146
2007-12-31,ADF (D),7639350,1349300,7995700,16984350,0.0,0.0,0.0,0.0,31004,3755,26530,61289
2007-12-31,ISE (I),29207900,320300,1012500,30540700,0.0,0.0,0.0,0.0,189680,399,2928,193007
2007-12-31,CHX (M),17724800,2914700,8632212,29271712,0.0,0.0,0.0,0.0,17221,1500,7181,25902
2007-12-31,NYSE (N),1146704310,0,0,1146704310,0.0,0.0,0.0,0.0,3342978,0,0,3342978
2007-12-31,NYSE Arca (P),251520042,156496548,199028810,607045400,0.0,0.0,0.0,0.0,1458361,394783,930191,2783335
2007-12-31,Nasdaq (Q),395743329,181810763,765187701,1342741793,0.0,0.0,0.0,0.0,2053729,539074,2805294,5398097
2007-12-31,CBOE (W),2099700,5995300,529600,8624600,0.0,0.0,0.0,0.0,1507,1966,539,4012
2007-12-31,PHLX (X),2076400,141800,817329,3035529,0.0,0.0,0.0,0.0,3595,62,1884,5541
